####################################################################################################                                                                                                  
# # #   #   # # # #   # # # # # # # # # # # ### # #   ###       # # # # # # # # # # # # # # # # # #                                                                                                  
# # # ### ### # # # ### # # # # # # # # # # ### # # ##### ### ### # # # # # # # # # # # # # # # # #@                                                                                                  
# # # ### ###   #   ### # # # # # # # #   # # # # # ### # ### # # # # # # # # # # # # #   # # #   #                                                                                                  
# # # ### ##### # ##### # # # # # # # # ### # # # # ### # ##### # # # # # # # # # # # # ### # # ###                                                                                                   
# # # #   ##### # ###   #   # #   #   # ### # # # # #       ###   # # # # # # # # # # # ### # # ###                                                                                                  
# # # # ####### # ##### # ### # ### ### ### # # # # # ### # ##### # # # # # # # # # # # ### # # ###                                                                                                   
# # #   ### # #   # ### # ### # ### ###   # #     #   ### # ##### # # # # # # # # #   # # # # # # #                                                                                                  
# # # ##### # # ### ### # ### # ### ### ### # ##### ############# # # # # # # # # # ### # # # # # #                                                                                                   
#     ### # # # ### ### # # # # ### ### ### # ##### ### ###     # # #   #     # # # ### # # #                                                                                                  
##### ### # # # ### ### # # # # ### ### ### # ##### ### ####### # # # ### ##### # # ### # # # #####                                                                                                   
##### #   # # #   # # #   # # # ### # # ###   # # # ### # ##### #     ### ##### # # #   #     #####                                                                                                   
##### # ### # # ### # # ### # # ### # # ### ### # # ### # ##### # ### ### ##### # # # ### #########                                                                                                  
# #   # ###   # ### # # ### # #   # # # # # ### # # #   # # # # # ### ### #   # #   # ### ##### ###                                                                                                   
# # ### ##### # ### # # ### # # ### # # # # ### # # # ### # # # # ####### # ### # ### ### ##### ####                                                                                                  
# # ###   ### # # # # # #     # ### # # # # # # #   # ### #   # # # ### # # ### # ###   # # # # # ##                                                                                                  
# # ##### ### # # # # # # ##### ### # # # # # # # ### ### # ### # # ### # # ### # ### ### # # # # ##                                                                                                  
# # # ### # # # # # # #   ###   # # #   #     # # ### # # # ### #   # #         # #   ### # # # # #                                                                                                   
# # # ### # # # # # # # ####### # # # ### ##### # ### # # # ### # ### # ######### # ##### # # # # #                                                                                                  
#   # # # #   # # # # # ### ### # # # ### ###   # # # # # #   # # ### # ######### # ### #     #   #                                                                                                   
### # # # # ### # # # # ### ### # # # ### ##### # # # # # # ### # ### # ######### # ### # ##### ###                                                                                                  
### # # #   ### #     #     # # # # # # # # ### # # # # #   ### #   # # # # # # # #   # # ###   ###                                                                                                   
### # # # ##### # ##### ##### # # # # # # # ### # # # # # ##### # ### # # # # # # # ### # ##### ###                                                                                                  
# # # #   ### # # ###   ###   # # # #   # # # # # # # # # ### # # ### # # #   #   # ### # # ### ###                                                                                                   
# # # # ##### # # ##### ##### # # # # ### # # # # # # # # ### # # ### # # # ### ### ### # # ### ###                                                                                                  
# #   # #####     ##### # ### # # # # ###   # # # # # # # # #   # #     # # ### ### #   # # # # # #                                                                                                   
# ### # ##### ######### # ### # # # # ### ### # # # # # # # # ### # ##### # ### ### # ### # # # # #                                                                                                  
# ### # # # # ##### # # # #   # # # # # # ###   # # # # # # # ### # ### # # ### # # # ### # # # #                                                                                                     
# ### # # # # ##### # # # # ### # # # # # ### ### # # # # # # ### # ### # # ### # # # ### # # # # ##                                                                                                  
# #       # #   # #   # # # ### # #   # #   # ###         # # # # # ###   # # # # # # # # # # # # ##                                                                                                  
# ### ##### # ### # ### # # ### # # ### # ### ### ##### ### # # # # ##### # # # # # # # # # # # # ##                                                                                                  
# ### ###   # ### # ### # # # # # # ### # ###   # ##### #   # # # # # ### #     #   # # #   # # # #                                                                                                   
# ### ##### # ### # ### # # # # # # ### # ### ### ######### # # # # # ### # ##### ### # # ### # # #                                                                                                  
# #   # ### # # # # # # # # # # #   # # #   # ### # ####### # # # # # # #   ##### ###   # ### # #                                                                                                     
# ### # ### # # # # # # # # # # # ### # # ### ### # ####### # # # # # # # ####### ### ### ### # # ##                                                                                                  
# ### # # # # # # # # #   # # # # ### # # ### # # # ### # # # # # # # # # ### # # # # ### # # # # ##                                                                                                  
# ### # # # # # # # # # ### # # # ### # # ### # # # ### # # # # # # # # # ### # # # # ### # # # # ##                                                                                                  
# # # # # # # #   # # # ### # # # # # # # # # # # # # # # # #   # # # # # # #   # # # #   # # # # #                                                                                                  
# # # # # # # # ### # # ### # # # # # # # # # # # # # # # # # ### # # # # # # ### # # # ### # # # #                                                                                                   
# # # # # # #   ### # # # # # # # # # # # # # # # # # # #     ### # # # # # # ### # # # ### # # # #                                                                                                   
# # # # # # # ##### # # # # # # # # # # # # # # # # # # # ####### # # # # # # ### # # # ### # # # #                                                                                                  
# # #         ##### # # #   # # # # #   # # #     # # # # ##### # # # # # # # # # # # # ### #   #                                                                                                  
# # # ### ######### # # # ### # # # # ### # # ##### # # # ##### # # # # # # # # # # # # ### # ### ##                                                                                                  
#     ### ##### # # # # # ### # # # # ### # # ###   # # # # ###   # # #   # # # # #   # # # # ### ##                                                                                                  
# ### ######### # # # # # ### # # # # ### # # ##### # # # # ### ### # # ### # # # # ### # # # ### ##                                                                                                  
# ### # ### ### # #   # # ###   #   # # # # # # ### #   #     # ### # # ### # # # # ### # # # # #                                                                                                  
##### # ### ### # # ### # ### ### ### # # # # # ### # ### ##### ### # # ### # # # # ### # # # # # ##                                                                                                  
### # #   # # # # # ### # # # ### ### # #   # # # # # ### ##### # # # # # # # # # # # # # # # # # ##                                                                                                  
### # # ### # # # # ### # # # ### ### # # ### # # # # ### ##### # # # # # # # # # # # # # # # # # ##                                                                                                  
#     # ### # # # #   # # # # # # # #   # ### # # # #   # # # # # # # # # # # # #   # # # # # # # #                                                                                                  
# ### # ### # # # # ### # # # # # # # ### ### # # # # ### # # # # # # # # # # # # ### # # # # # # #                                                                                                   
# ### #   # # # # # ### # # # # # # # ### ### # # # # ### # # # # # # # # # # # # ###   # # # # # #                                                                                                  
# ### # ### # # # # ### # # # # # # # ### ### # # # # ### # # # # # # # # # # # # ### ### # # # # #                                                                                                   
# ###   ### # #   # # # #   # # # # # #   ### #   # # ### # # #   # # # # # # # # # # ### # # # # #                                                                                                  
##### ##### # # ### # # # ### # # # # # ##### # ### # ### # # # ### # # # # # # # # # ### # # # # #                                                                                                   
### # ##### # # ### # # # ### # # #     ### # # ### #   # # # # ### # # # # #   # # # #   # #   # #                                                                                                  
### # ##### # # ### # # # ### # # # ####### # # ### # ### # # # ### # # # # # ### # # # ### # ### #                                                                                                   
# # # # # # # #   # # # # # # # # # ###   # # # # #   ### # # # # # # #       ###   # # ### # ### #                                                                                                  
# # # # # # # # ### # # # # # # # # ##### # # # # # ##### # # # # # # # ######### ### # ### # ### #                                                                                                   
# # # # # # # # ### # #       # # #   ### #     # # ###     # # # # #   ####### # ###                                                                                                  
# # # # # # # # ### # # ### ### # # ##### # ##### # ##### ### # # # # ######### # ### ######### ####                                                                                                  
#     # # # # # # # # # ### #   #   ###   # ##### # # ### ### # # # # ### # # # # # # ######### #                                                                                                  
# ##### # # # # # # # # ####### # ####### # ##### # # ### ### # # # # ### # # # # # # ########### ##                                                                                                  
# ### # # # # # # #       ##### # ### ### # # # # # # # # # # # # # # ### # # # # # # # #     ### ##                                                                                                  
# ### # # # # # # # ### ####### # ### ### # # # # # # # # # # # # # # ### # # # # # # # # ### ### ##                                                                                                  
# ###   # # # #   # ### ##### # # # # # # # # # # # # # #                                 ###                                                                                                         
# ##### # # # # ### ######### # # # # # # # # # # # # # # ### # # # # # # # # # # # # # # ##########                                                                                                  
# # ### # # #   ###   ##### # # # # # # # # # # # #       ### # # # # # # # # # # # # # #         ##                                                                                                  
# # ### # # # ##### ####### # # # # # # # # # # # # ### ####################### ####################                                                                                                  
# # # # # # # ### # ##### # # # # #     # # # # #   ### ### # # ### ### #   ### ### # # # # ##### #                                                                                                   
# # # # # # # ### # ##### # # # # # ##### # # # # ######### # # ### ### # ######### # # # # ##### #                                                                                                  
# # # # # # # # # # # # # # # # # # #####         ### # # # # # # # # # # ### ### # # # # # # # # #                                                                                                   
# # # # # # # # # # # # # # # # # # ##### ### # ##### # # # # # # # # # # ### ### # # # # # # # # #                                                                                                  
# # # # # # #                             ### # ### #                                                                                                  
# # # # # # # ### # # ### # ### # # # # # ######### # ### # # # ### # # # # # # # # # # # # # # # #                                                                                                   
# # # # # # # ### # # ### # ### # # # # #             ### # # # ### # # # # # # # # # # # # # # # #                                                                                                  
# # # # # # # ############# ### # # # # # # # # ##### ### # ### ### # # ##### # # ##### # # # # # #                                                                                                  
#I            ### # ### ###   # # # # # # # # # ##### ### # ###   # # # ##### # # ##### # # # # # #                                                                                                   
# # # # # # # ### # ### ### # # # # # # # # # ####### ##############################################                                                                                                  
# # # # # # #       ### # # # # # # # # # # # ##### #   ### # # #                                                                                                  
# # # ### # # # ####### # ######################### ####### # # # ### ##### # # # # # # ### # # # #                                                                                                  
# # # ### # # # #####                                             ### ##### # # # # # # ### # # # #                                                                                                   
# # # ##### # # ##### ### # ### # # # # # ### # # # # # # # # # # ########### ### # # # ### # # ###                                                                                                  
# # #   ### # #       ### # ### # # # # # ### # # # # # # # # # #         ### ### # # #   # # # ###                                                                                                   
# ### # ### # # ### # ############################### # # ### # # # # # # ######### # # # # # #####                                                                                                   
# ### #   # # # ### #                             ### # # ### # # # # # #       ### # # # # # #####                                                                                                  
# ##### # # # # ### # ##### # # # # # # # ### # ##### # # ### # # # # # # # ### ####################                                                                                                  
# ##### # # # #   # # ##### # # # # # # # ### # ##### # #   # # # # # # # # ###                                                                                                  
# ##### # # # # # # # ##### # ### # # # # ### # ##### # # ### # # # # # # # ### # # # # # # ### ####                                                                                                  
# ###   # # # # # # #     # # ### # # # #   # # ###   # # ### # # # # # # #   # # # # # # # ### ####                                                                                                  
# ##### # # # # # # # # ##### ### # # # # # ### ### # # # ### # # # # # # # # # # ### # # # ### ####                                                                                                  
#     # # # # # # # # # #####   # # # # # # ### ### # # #   # # # # # # # # # # # ### # # #   #                                                                                                       
# # ##### # # # ### # # ####### # # # # ### ### ##### # # # # ##### # # # # # # # ### # # # # # # #                                                                                                  
# # ##### # # # ### # #     ### # # # # ###   #   ### # # # # ##### # # # # # # #   # # # # # # # #                                                                                                   
# # ##### # # # ### # # # # ### # # # # ##### # # ##### # # # ##### # ### # ### # # # # # # ### # #                                                                                                  
# #     # # # #   # # # # #   # # # # #   ### # #   ### # # #     # # ### # ### # # # # # # ### # #                                                                                                  
# # # # # # # # # # # # # # # ### # # # # ### ### # ##### # # # # # # ##### ### # # ### ### ### # #                                                                                                   
# # # # # # # # # # # # # # # ### # # # #   # ### #   ### # # # # # #   ###   # # # ### ###   # # #                                                                                                   
# # # ### # # # # # # # # # # ##### # # # # # ### # # ####### # # # # # ####### # # ### ### # # # #                                                                                                  
# # # ### # # # # # # # # # #   ### # # # # #   # # #     ### # # # # #   ##### # #   #   # # # # #                                                                                                  


DDDDDDDDDDDDWWWWDDDDDDDDDDDDDDDDDDDDDDDDDDDDWWDDDDDDDDWWDDWWDDDDDDWWDDDDDDDDDDDDDDDDDDDDDDDDDDDDWWWWWWWWWWWWWWDDWWWWWWWWWWWWWWDDWWWWWWWWWWWWWWWWWWWWWWWWWWDDDDWWDDDDDDWWWWWWW